1111111111111
1C000000000C1
1110011111001
1P00111CE0001
1111111111111