1111111111111111
10M10000000C01C1
1C00011111M00101
1P0011E000000001
1111111111111111